8 13 1 0 8 10
*************
   ***** ** *
**  **   ** *
***  ***  * *
**  ** **   *
** **     ***
**     **  **
********** **
