8 13 1 0 7 10
*************
   ***** ** *
**  **   ** *
***  ***  * *
**  ** **   *
** **     ***
**     *** **
********** **
***   *******

